#########...............#################
#########...................#############
#########...................#############
#########...................#############
#########...................#############
#########...................#############
#########..........###....###############
##############.....###....###############
##############.....###....###############
##############..............#############
##############..............#############
##############.......##.....#############
##################...##.....#############
##################....##.......##########
##################....##.......##########
##################....##.......##########
##################.............##########
##############.................##########
##############.................##########
##############.................##########
##############.....................######
##############.....................######
##############.....................######
##############.....................######
##############.....................######
####################...............######
####################...............######
##########################.........######
##########################.........######
##################.................######
##################.................######
##################.................######
##################.................######
##################.........##############
##############..........#################
##############..........#################
##############..........#################
##############..........#################
##############.......####################
##############.......####################

